TILEMAP
320 58
16 32
images/blocks_moon.png
2 2
                                                                                                                                                                                                                                                                                                                                
                                                                                                                                                                                                                                                                                                                                
                                                                                                                                                                                                                                                                                                                                
                                                                                                                                                                                                                                                                                                                                
                                                                                                                                                                                                                                                                                                                                
                                                                                                                                                                                                                                                                                                                                
                                                                                                                                                                                                                                                                                                                                
                                                                                                                                                                                                                                                                                                                                
                                                                                                                                                                                                                                                                                                                                
                                                                                                                                                                                                                                                                                                                                
                                                                                                                                                                                                                                                                                                                                
                                                                                                                                                                                                                                                                                                                                
                                                                                                                                                                                                                                                                                                                                
                                                                                                                                                                                                                                                                                                                                
                                                                                                                                                                                                                                                                                                                                
                                                                                                                                                                                                                                                                                                                                
                                                                                                                                                                                                                                                                                                                                
                1                                                                                                           1                                                                                                                                                                                                   
                111                                                                                                         1111111                                                                                                                                                                                             
                1111                                                                                                        11111111                                                                                                                                                                                            
                1111                                                                                                        11112111                       1111    1                              11 111111111                       111111                                                                       1111          
                1111                         1     1   11111111                        1111111       1                  1111111121111                      111111111                         11111111111111111                      11111111111 11                               111                          111111111         
                111111111111                 111111111111111111                     111111111111111111                  1111111111111                     11111111111                       11111111121111111111                   111111111111111                            1  11111111                     111111111111111   
           11111112111111111                 11111111111111111111                111111112111111111111                  11111111111111                    12111111111111111                 11111121111111111111                 111111111111111111                     111111111111111111              111111111111111111111   
 11     111111111111111111111111            111111111111112111111         11111111111111111211111111111111              111111111111111111111             111111211111111111 1111111      1111111111111121111111  1111      1111111111111111211111111111111111      111111111111111111111111            1111111111111111112111  
 11111  1111111111111112111111111       111111111111111111111111111     11111111111111111111111111111111111             11111112111111111111111           11111211111111111111111111   1  1111111111111112111111111111111111111111111111111111111111111111111111 111111111112111111112121111 11         11111111111212111111111 
11111111111111112111111111111111111111111111111111111111111111111111111111111111111112111121111111111111111        1111111111111111111112111111 11     1111111111111113111111111111111111 11211111111111111111111111121111111111111111111121111111111111111111111111111111111111111111112111111       11111111111211111211111111
11121111111111111111111111111111111111111111111111111111111111111111111111111111111111111111111111111111111111111111111111111111112112112111111111111111111111111111111111111111111111111112111111111111111111111111111111211111111111111111111111111111111111111111111111111111111111111111111   111111111112111111211111111211
11211111111111211111111111111111111111111111111112111111111111112111111111111111111111111112111211121111111111111111111112111111111111111111111111111111112111111112111111111111111111111111121311111111111111111111211111111111111111111111111111111111111111111111111111111112121111111111111111111111111111111111111111111111
11111111111111112111111111111111111111111111111111112111111111111111111111111111112111111111111111111111111111111121111211111111111111111211111121111121111111111111111111121111111111111111111112111111111111111111121111111111111111111111111111111111111111111111111111112111111111111111111111111112111111111111111111111111
11111111111111111111111111111111111111111111111111111111111111111111111111111111111111111111111111111111111112111111111111221111111111211111111111111111111211122111111111111111111111111111111111111111111111111111111112112111111121111111111121111111111111121111111112111111111111111111111111111111111111111111121111111111
12111111111111121112111111111111111111111111111111111111111111112111111111111111111111111111111111111111111111111123111112111111111211111131111111111111111111111111111111111112211111111111111111111111111111111111111111111112111111111111111111111111111111111111111111111112111111112111111321111111111111111111111111111111
11111111111121111111111111111121121111111111111111121111111111111111111111111111111211111121111111111111111111111111111111111111111211121111111111111111111111111111111111111111112121111111111111111211111111111111111111121111111111111111111111111111111111111111111111211111111111111111111111111111112111111111111111111111
11111111112112111111121111111111111111111111111121111211111111111111121112111121111111111111111121111111111111111111111111121111111111111111111121111211111111111111111111111111111111111111111111111111113111121111311111121111111111111111111111111111121211112111111111111111121111111111111111111112113111111121111111121111
11111111111111111111111112111112112111111111111121111111111111111111111111111111111111111111111131111111112111111111111111111111111111111112111111111111111111111111111111111111111111111111111111111111111111211111111111111111111111111111111111111111111111111221111121211111312111111111211111111111211111111111112111111111
11111111111111111111111111111112111111121111111111111111111111111111111111111111111111111111111111111121211111112112111111111111121111211111111111111111111111111111111111121111111111111111111111111111111112111111111111111111111111111121111111111111111111111111111111111111111111111111111111111111111111211111111111111111
11112111111111112111111111111111111111111111111111111111111111111131121111111121111111111121111111121111111111111111111112111111111111111111111111112111111121111111111111121111111111111111111111111112211111111111111111111111111111111111111111111111111111111111111111111111111111111111221111111111111111121111111111111111
11111112111111111111111111111111111111111111111111111111111111111111111111111111111111111111111221111111111211111111111111111111111111111112121111111111111111111111111111111111111111111121111111221111111111111111111111111111111113211111111111111111111121211111111111211111111111111111111111111112111111121111111111111111
11111111112113111111111111122111111111111111111111111111111211111111111111111111111111111111111111111111111111111111111111111211111111111111111111111111111111111111121111111211111111121111111111111111111111111111111111111111111111111111111111111211111111111111211111111111111111111111111112111111111111111111111211111111
11111111111121111111111111211111221121121111111112111111211111111111111111111111211111111111111111111112111111111111111211111111111111111111311111111111121111111112111211112111111111121111112111211111112211111111121211111111211111111111111111111112121111111111111111111111111112111111111111111111111111221111111111111111
11111111111111111112111111111111111111111111121111111111111111111111111111111111111111121111111111111111111111212111111111111111112111111311112111111111111111111111211111111111111111111111111111121111111111111111111121111122111121111111111111111111111111111111111211111111111111111111111111111321111111111111111111112111
11111122111111111111111111111111111111111111111111121211111111111111111111111111211112111111111111111111111111111111111111111111111111111111111111111111112111122111111112111111111111111111111121111111111111111112111112111111111211212111111111111111111111211111111111111111311111121111111111111111131111111111111111111111
21111111111111111111111111111111111111111111111111111111211111111111111111111211111111211111211111111111111111112111111111111111111111111111111111111111111111111111111121111111111211111111211111111111111111111111111111111111111111111111111111111112111111111113112111111112111111111211211111111111111111211111111111111111
11111111111111111111111111111111111111111111111111112111111211111111211111111111111111111111111111111111111111111111111111111111111111111111111111121111111131111111211111111111111111111111121111111111211111111111111111111111112111111111111111111111111111111111111111111211111111111111121111111211111111111111111111111211
11111111111111111111111111111121111111111111111111111111111111111111111111111111111111111111111111111111212111111111111121111111111111111111111321111111111112111111111111121111111111111111111112111111111111111111111111121111111111111112111111111111111111121111111111211112111112111112111111112111111111111111212111111111
11111111121111211111111111111111111111111111111111111111111111111111111111111111111111111111111111111111111111111111111111111111111211111111211111111111111111111111111111111111111112111111111111111111111111111111111111121111111111111111121111111111111111111111111111111111111111111111111111111111121111111111112121111111
11121111111112111121111111111111112112111111111111111111111111111111111111121111111111121111111111111111111111111111111112111111111111111111112111111111111111111111111111111111111111111111111111111112111111112111111111111221111121111111111111111111111111111111111211111111111111111111111112111111111211112111112111111111
11111111111111111111112111111111111111111111111111111111111121111131111111111111111111111111111111111111111111111111111111111111111111111111111111111111111111111111111111111111111111111111111112111111111111111111111221111111111111111111211111111211111121111111111121111111211112112111121111111111111111111111111111111112
11111121111111111111111111111211111111111111111111111111111111111111111111111211111111111111211111111111111111111111111111111111111111111111111111111111112111121111111111111111111111111111111111111121111111111111111111111111111111111111111111111111111111211111111111111111111111111121111111111111111211111211111111111111
11111111131111111111111111111111111111111111111111111111111111111111111111111111111111211111111111211111111111111111111111111111111111111211111211121211111112211111111111111111111121111211111121111111111221111211111111111111111111111111112111121211112111112111111111111111211111111111111111112111111111111111111111111111
21111111112121111111111111112111111121111111111111111111111111111111111111111111111111111111111111111111111111111111111111111111111111111111111211111111111111112111111111111111111111111111111111111111111111111111111111111111111112111111111111111111111111111111111111111111111111111111112111111111111111111111111111111111
11111111111111111112111112111111111121111111111111111111111111111111111111211111111111111111111111111111111111111111111111111111111111111111111111111111111111111111111112111111111111111111111111111111111111111111111111121111111111111111111111111111111111211111121121121111111111111111111111111111211111111111111122111111
11111111121111121111111111111111111111111111111111111113121111111111111111111111111111111111111111111111111111111111111111111211111111111111111211111111111111111111111111111111111111111111111111111112111111111111111111111111111111111111111111111111111111211111111111112111111111111113111111111111111111111111112111111111
11211111111111112111111111211111111121111111112111211111111111111121111111111111111111111111111111111211111111111111111111112111111111111111211111111111111121111112211111111111111111111111111111111111111211111111111111211111113111111111111112111111111111111112112111111111111111121111112111111111121111111111111121111111
11111111111111121111111111111112111111111111111211111211111111112111111111212111111111111111111112111111111111111111111111111211221111111211111111111111111111111111111112111111111111111111111111111111111111111111111111111111111111111111111111111111111111111111111111111112111111112111111121111111111111111111111111111111
11111111111111111111111111111111111111111211111111111111111111111111111111111111111111111111121111111111111111111111111111111121111211111113111111111111112111111121111111111121111111111111111111111111111111111111111111111112111111111111111111111111111111211111111111111112122111111111111311111111111111111212111111111111
11111111111111111111111121111211211112111111111111111111111111111111111111111111111112111121111111111111211111111111211111111111111111111111111111111112111111111111111111111111212111111111111111111111111111111111111111111211111111111111121111111111111111111111111111111211111111111111111121211111112111111111111111111111
11111112111111111111111111111211111111111111111111111111111111111111111111111111111111111111211121111111111211111111111111111111111211111111111111112111111111111111111111111111111111111112111111111111111111111111111111111111111111121111111111112111111111111111111121211211111111111112111112111111111111111111111111121111
