TILEMAP
320 58
16 32
images/blocks_moon.png
2 2
                                                                                                                                                                                                                                                                                                                                
                                                                                                                                                                                                                                                                                                                                
                                                                                                                                                                                                                                                                                                                                
                                                                                                                                                                                                                                                                                                                                
                                                                                                                                                                                                                                                                                                                                
                                                                                                                                                                                                                                                                                                                                
                                                                                                                                                                                                                                                                                                                                
                                                                                                                                                                                                                                                                                                                                
                                                                                                                                                                                                                                                                                                                                
                                                                                                                                                                                                                                                                                  11111111111111             11           11111 
                                                                                                                                                                                                                                                                              11111111111111111111111   11111111111   1111111111
                                                11111111111111111                                                                                                                                                                                                          11111111111111111111111111111111111111111111111211111
                                             111111111111111111111111111                                                                                                                                                                                         111111111111111111111122111111111111111111111111111111111111111
                                            111111111111111111111111111111                                                                                                                                                                                   1111111111111111111111111122111111111111111311111111111111111113111
                                          1111111111211111111111111111111111                                                                                                                                                              1111111111      1111111111111111111111111111211111111111111111111111111111111111111111
                                1111111111111111111121111111111111111221121111                                                                                                                                                          1111111111111111111111111111111111111111111122111111111111111111111111111111111111111111
                   1111       11111111111111111111111111111111111111122222211111                                                                                                                                                      111111111111111111111111111111111111111111111222111111111111111111112211122111111111111111
                 111111111111111111122211111111111111111111111111111122221111111111                                                                                                                                                  1111111111111111111122111111111111111111111111221111111111111111111122211111111112211111111
                1111111111111121111122211111111111111111111111111111112221111111111111                                                                                                                                              11111111111111111111222111111111111111111111111111111111112111111111222211111111112221111112
              111111111111111222111111111111112221222111111111111111111111111111111111111                                                                                                                              11111      1111112111121111111111222111111111121111111111111111111111122211111111122211111111111221111122
             11111111111221122211111111111111122222221111111111111111111111111111122221111111111                                                                                                                     11111111111111111222111111111111111221111111111111111111111111111111111122221111111112211111111111111111122
            1131111111122222221111111111111112211222211111221111111111111111111111122211111111111111                                                                                                                111111121111111111221111111111111111111111111111111111111111111111111111122221111111111211111111111111111111
          111111111111112222111111111111111122211222111111222111111111111111111111112211122211221111111                                                                                                            1111111111111111112221111111111111111111111111111111111311111111111112111122211111111111211111111111111111111
         111111111111111122111111111111111111111111111111122211111111111111111111111111112222222111311111                                                                                                        111111111111111111112111111111111111111111111111111111111111111122221122222222111111111112211111111111111111111
       1111111111111111111111111111111111111111111111111112221111111111221111111111131122111222211111111111                                                                                            1111111111112211111111111111221111111111111111131111111111111111111111111122211222222221111113111221111111111111111111111
     11111111111111111111111111111111111111111111111111111222111111111222211111111111122211112211111111111111                                                                                        111111111111112221111111111111211311111111111111111111111111111111111111111122111222222221111111112221111111112111111111111
1111111111112221111111111111111111111111111111111111111111122211111112222221111111111222111131111111311111211111                                                                                    1111111211111112221111211111111111111111111111111111111111211111111111111111111111222222111111111122221121111111111111111111
111111111111222211111111111111111111311111111111111111111112221111122222222111111111122111131111111111111122211111                                                                                 11111111111111112221122221111111111111112111221111111111111111111111111111111111111122221111111111111111122211111111111111111
11111111111111221111111111111111111111111111111111111111111122111112222222211111111111111111111111111111112221111111                                                                   111      11111111111111111122211122211111111111111111122221111121111111111111111111111111111111112211111111111111111122211111111111222131
111111111111111111111111122211111111111111111111111111111111111111122222221111111111111111111111111112211122111111111                                                               11111111111111111111111111111222111112111111111111111111122221111111111111111111111111111111111111111111111111111111111112211111111111222111
1111111111111111111111112221111111111111111111112111111111111311111111112111122111111111111111111111111111111111111111                                                            1111111111111122111121111122112221111111111111111111111111112211111111111111111111111111111111211111111111111111111111111111111111111112222221
11111111111111111111111221111111111111111111111121111111111111111111111111111111111111111111121111111111111111111111111                                                          11111111111112222111111111122222211111111111111111111111111111111111111111111111111131111111111111111111311111112111111111111111111111111222222
1111111111111111111111111111111111122211111111111111131111111111111111111111111111111111111111111111311111111111111211111       111111                                         1112221111111112221111111111122222111111111111111111111111111111111111111111111111111111111111111111111111111111122111111111111111111111111222222
1111111111111111111111111111111111122221111111111111111111111111111111111111111111111111111111111111111111111111111211111111111111111111                   111               111122211111111112211111111111112221111111111111111111111111111111111111111111111111111111222111111111111111311112222111111111111111111111111122211
111111111111111111111111111111111111222111111111111111112111111111111111111111111111111111111111111111111111111111111111111111111111111111          1111111111111         111111221111111111111111111111111111111111111111111111111111111111111111111111111111111111111222111111111111111111112211111111111111111111111111111111
111111122111121111111111111111111111111111221111111111111111111111111111111111111111111111111111111111111111111111111111111111111111111111111   11111111111131111111 11111111111111111111111111111111111111111111111111111111111111221112211111111111111111111111111111221111111111111111111111111111111111111111111111111111111
11111111111111111111111111111111111111111111111111111111111111112111111111111111111111111111111111111111111111111111111111131111111111111111111111111112211111111111111111111111111111111111111222211111111111111111111111111111111111122211112111111111111111111111111111111111112111111111111111111111111111111112211111111222
11111111111111111111111111111111111111111111111111111111111111122211111111111111111111111111111111111111111111111111111111111111111111111111111111111122211111111111111111111111111111111111112222221111111111111111111211111111111111122211111111122211111111111111111111111111111111111111111112211111111111111122211111112222
21111111111111111111121111111111111111111111111111111111111111222211111111111111111111111111111111111111122111111111111111111111111211111111111111111122111111111111111111113111111111111111112222221111111111111111111111111111111111122211111111112221111111111111111111111111111111111111111111111111111111111122211111112221
21111111111111111111122111221111111111111111111111111111111111232222111111111111111111111111111111111111122211111111111111111111111211111111111111111111111111111111111111111111111111111111111111111111111111121111111111111111111111122211111111112221111111111111111111111111111111111122211111111111111111111111111122222211
11111111111111111111111111111111111111111112111111111111111111222222211111111111111111111111111112211111122211111121111111111111111111111111222111111111111111211111111111111111111111111111111111111111111112222111111111111111111111112211111111111111111111111111111211112111111111111122211111111111111111111111111122221111
11111111111111111111111111111111111111111112111111111111111111122222111111111113111111111211111112231111122111111222111111121111111111111111222111111113111111111111211111111121111111111111111111111111111122222211111111111111111111111111111111111111111111111111122211111111111111111112211111111111111111111111111112211111
11111111111111111111111111111111111111111111111111111111111111112221111111111111111111111211111112221111221111111122111111222111111111211112221111111111111111111111231111111121111121111111111111111111112222222211111111111111111111111111111111111111111111111111122111111111111111111111111111111111111111111111111111111111
11111111111211111113111111111111112213111113111111111111111111111111111111111111111111111111111112221122221111111112111112221111111111111111111111111111111111111111111111111111111111111111111111111111112222222211111111112211111111111111111111111111122211111111122111111111111111111111111111111111111111111111111111111111
11111111111111111111111111111111122211111111111111111111111111111111111111111111111111111111111112221122211111111111111112211111111111111111111111131111111111111111111111111111111111111111111111111111112222222111111111112221111111111111211111111111112221113111111111111111111121111111111111111111111111112221111111111111
11121111111111111111111311111111122111111111111111111111111111111111222111111111111111111111111112213122111111111111111121131111111111111111111111111111111111111111111111111111111111111111111111111111111111121111221111111221111111111111111111111111111221111111111111111111111221111111111122111111111111112222111111111211
11222111111111111111111111111111221111111111111111111121111111111111222211111111111221111111111111111111111111111111112221111111121111111111111111112111122111111111111111111111111111111111111122211111111111111111111111111221111111111111111111111111111111111111111111111111112221111111111122213111112111122222211111111111
12222111111111121111111111111112211111111111111222211221111112111111122211111111111111111221111111111111111111111111111111111111121111111131111111111111111111111111111122111111111111111111111121111111111111111111111111111111111111111111111111112211111111111311111111111111112211111111111112211111111111222222221111111111
12222111111111222111111111111122111111111111111222222111111122211111111111122111111111111111111111111113111111111111111111111111111111111111111111111111111111111111111222111111111111111122222211111111111111111111111111111111111111111111111111111111111111112111111111211111121111311111111111111111111112222222211111311111
12222222111111122111111211111111111111111111111222222111111112211111111111321111111111111111111111111111111111111111111111111111111111111111111111111111111111111111111221111111111111111111222211111111111111111111111111111111111111111111111111111111111111111111111111111112221111111111111111111111111112222222111111111111
11222222211111111111111222111111111111111111111222222111111111111111111112221111111111111111111111111111111111111111113111111111111121111121111111111111111111111111111111111111122111111111222111111111111111111111111111111112111111111111111111111111111111111111111111111111111111111111111111111111111111222211111111111111
11122222211111111111111222111111111111311111111122221111111111111111111112211111111121111111111111111112111111111211111111111111111111111121111111111111111111111111131111111111111111111111121111111112111111111111111111111112111112111111111111111111111111111111111111111111111111111111111111111111111111122111111111111111
11111111111111111111111122111111111111111111111122211111111111111111111111111111111111111111111111111111111111111111111111111111111111111111111111111111111111113111111111111111111111111111111111111122211111111111111111111111111111111111111111111211112111111111111111111111111131112111111111111111111111111111111111111111
11111111111111111111111111111111111111111111111211111111111111111111111111111111111111111111111111111111111111111111111111111111111111111111111111111111111111111111111111111111111111111111131111111122211111111111111211111111113111111111111111111211122111112111111111111111111111111111111111211111111111111113111111111111
11111111111111111111111111111111111111111111112211111111111111111111111111111111111111111111111111111111111111111111111111111111111111111111111111211111111122111221111111111111111111111111111111111222222111111111111111111111111111111111111111111222211111112111111111111111111111111111111122222111111111111111111111111111
11111111111122111111111111111111111111111111111111111111121111111111111111111111111111111111121111111111111111111111111122221111111111111121111111111111111111112221111111111111111111111111111111111222222211111111111111111111111111122211111111111222211111111111111111111111111111111111111122222211111111111111111111111111
11111111111122211111111111112111111111111111111111111111221111111112211111111111111111111111111111111111111111111111111222222111111111111122111111111111111111112211111111111111111111112111111111111122222111111111111111111111111111222221111111111222211111111111111221111111111111111111111121112111111111111111111111111111
11111111111122211111111111111111111111111111111111111112211111111122221111111111111111111111111111111111111111111111111222222111111111111111111111111111111111122211111111111111111111111111111111111112221111111111111111111111111122222221111111111222111111111111111111111111111111111111111111111111111111111211111111111111
