TILEMAP
320 58
16 32
images/blocks_moon.png
2 2
                                                                                                                                                                                                                                                                                                                                
                                                                                                                                                                                                                                                                                                                                
                                                                                                                                                                                                                                                                                                                                
                                                                                                                                                                                                                                                                                                                                
                                                                                                                                                                                                                                                                                                                                
                                                                                                                                                                                                                                                                                                                                
                                                                                                                                                                                                                                                                                                                                
                                                                                                                                                                                                                                                                                                                                
                                                                                                                                                                                                                                                                                                                                
                                                                                                                                                                                                                                                                                                                                
                                                                                                                                                                                                                                                                                                                                
                                                                                                                                                                                                                                                                                                                                
                                                                                                                                                            1111          11111         111111111111111111      1111111111111                                                                                                   
                                                                                                                                                          11111111      1111111111   111111111111111111111111111111111111111111111111111                                                                                        
                                                                                                                                                         1111111111111111111111111111111111111221111111111111111111111111111111111111111111                                                                                     
                                                                                                                                                        111111111211111111111211111111111111121111111111111111221111111111111111222111111111                                                                                    
                                                                                                                                            1111      1111111111222221111111111111221111111122111111111111111222111111111221111122111113111111                                                                                  
                                                                                                                                   11111111111111111111111111122222221111111111111111111111111111111111111111221111111112221111111111111111111111111                                                                            
                                                                                                                                11111111111121111111111111111222111111111111111111111111111111111111111111111111111111112211111111111111111111111111111                                                                         
                                                                                                            1111111111        111111111111222111111111111111122211111111111111111111111111111111111111111111111111111111111111111111111111111211111111111                                                                       
                                                                                                         1111111111111111111111121111111112221111111111111111111111111111111111111111111111111111111111111111111111111111111111111111111111112111111111111111                                                                   
                                                                                                       111111111111111111111111211111111112111111111111111111111111111111111111111111111311111111111111111111111111122111111111121111211111111111111111111111111                                                                
                                                                                       1111           111112222111111111111112211111111111111111111111111111111111111111111111111111111111111111111111112111111111122211111111111111111111111111111111111111111111                                                              
                                                                                  111111111111      1111112222221111111111111211111111122111111111111111111111111111111112221111111111111111111111111111111112111122211111111111111111111111111222111111111111111111                                                            
          111                                        111                    111111111111111111111111111111222222111111111111111111111122211111111111111111111111111111111321111111111121111111122111111111111111111111111111111111111111111112222221111111111111111111                                                          
   1111111111111              1111111             111111111             11111111111111111111111111111111111122221111111111111111111112222211111111111111111122211121111122211111111111111111111221111111111111111111111111111111111111111111122222211111111111111111111111                                                      
1111111111111111111         111111111111       11111111111111       111111111111111111111111111111111111111122221111111111111111111112222221111121111111111222211111111122221111111111111111112211111111111111111111111111111111111111111111111122221111111111111111111111111                                                   
1111121111111111111111111111111111111111111111111111111111111111111111111111111111111111111111111111111111111221111111111111111111112211111111112111111111122221111111111222111111111111111112221111111111111111111111111112111111111111111111111222111111111111112211111111111                                                 
111112111111111111111111111111111111111111111111111222111111111111111111111111111111111111111111111111111131111111111111111111111112211111111111111111111111221111111111112211112111111111111111111111122111111111111111111111111111111111111111122211111111111112221113111111111                                               
11111111111111111111122222221111111111111111111111122211111112111232111111111113111111111111111111111111111111111111121111111111111211311111111111111111111111211111111111111111111111111111111111111122211111111112111111111111113211111111111112222111111111111222211111111111111   1111111                                   
11111111111111311111112222222111111111111111111111112211111111112221111111111111111111111111111111111111111111111111111111111111111111111111111111111111111111211111111111111111111111111111111111111122211111111111111111111111111111111111111111222111111111111122111111111111111111111111111                                 
1111111111111122111311122222211111111111111111111111111111111112221111111111111111111111111111111111111111111111111111111111111113111111111111111111111111111111111111111111111111111111111111111111112211111111111111111111111111111111111111111111111112111111111221111111111111111121112221111                               
211111111111112211111131111111111112111121111111111111111111111122111221111111112111111111111111111111111111111111111111111111111111111111111111111111111111111111111111111111111111111111111111111111111111111111111111111111111111111111111111111111111111111111122111111111211111222112221111111      11111                  
21111111111111121111111111111111111111112111111111111111111111111111122211111111111111111112111111111111111111111111111111111211111111111111111111112222111111111111111111111111111111111111111111111111111111111111111111111111111111111111111111111111111111111112211111111221111222112222111111111111111111111111            
11111111111111111111111111111111111111111111111111111111211111111111122221111111111111111111111111111221111111111111111111111111111111111111111111122222211111111111111111111111221111211111111111111122222111111111111111111111111111111111111111111111111111111121111111111111111121111111111111111111111111111111111         
112211111111111111111111111111131111111111111111111111111111111113111122211111111112111111111111111111111111111111111111111111111111111111111111111222222111111111111111111111122211111111111111111111222222111111111111111111121111111111111111111111111111111122211111111221111111111111111111111111111111111111111111111     
11121111111111111111111111111111111111111111112221111131111111111111122211111111111211111111111111111111131111111111222111111111111111211111111111111111111111111111211111111122211111111111111111111122222211111111111111111122211111111111111111111111111111122221111111222111111111111111111111111111111111111111111111111111
11111111111111111111111111111211111111111111112221111111111111111111222111111111312211111111111111111111111112111112221111111111111122211111111111111111111111111111111111111122111111111111111111111111111111111111111111111122221111111111111111112211111111122211111112221111111111111111111122111111111121111111111111111111
11111111111111111111111111112211111111112211122211111111111111111111221111111111221111111111111111111111111113111112211111111111111222211111111111111111131111111111111111111221131111111111111111111111111111111111111111111122221111111111111111112221111111222211111111211111111111111111111222111111111121111111111111111111
11311111111111122211311111122211111111111111111111111111111111111112221111111112221111111112211111111111111111111122111111111111111221111111111111111111111111111111111111112221111111111111111111111111111111111111111112111222211111111111111111112221111112111211111111111111111111111111111221111111111111111111111222111111
11111111111111222111111111111111111111111111111111111111111111311111111111111122221111111111111111111111111111111222111111111111111221111111111111111111121111211111111111112222111111111112211131111111111111122111111122222222111121111111111111111111111322111221111111111111111111111111111111111111111111111111111122111111
11111111111112221111111111111111111111111111111111111111111111111111111111111122221111111111111111111111111111111222111111121111111222211111111111111111111111221111111111111222111111111111111111111112111111122211111322222221111131111111111211111111111111111111111111111111112211111111111111111111111111112211111112111111
11111111111111111111111111111111111211111111111111111111111121111111111111111111221111111111111111111111111111111122111111111111111222211111111111111111111111111111111111111111111221111111111111111111111111122211111222222221111111111111111111111111111111111111111111111111112222111111111111111111111111112221111111111111
11111111111111111111111111111111111211111111111111111111111111111111111111111111221111111111111111111111121111111112111111111111111222211111111112111111111111111211111111111111112222111111111111111111111111111111111222222111111111111111111111111111111111111111111111111111111222111111111111111111221111111211111111111111
11112221111111111222111111111111111111111111111111112111111111111111111111311112221111111111111111111111111111111111111111111111111222111111111311111111111111112221111111111111112222111111111221111111111111111111111122221111111111111111111111211111111111111111111111211111111111111221111111111111222111111111111111122111
11112211111111111222111111221111111111111111111113111111111111111111221111111122211111111111111111111111111111111111111111111111112211111111111111111111111111122211111111111111112222221111111222111111111111111111111112111111111111111111111112211111111111111111111111111111111111111111111111111111122111111111111111222111
11122111111111111122111112221111111111111111111111111111111111111111222111111121111111111111111111111111111111111111111222111111122111111111111111112111111111222111111111111111112222221111111122111111111111111111111111111111111111111311111121111111111111111111111111111111111111111111111111111111111111111111111131222111
11222111111111111111111112211111111111111112221111111111111111111111122111111111111111111111111111111111111111111111111222111111121111111111111111111111111111121111111111111111111222211111111111111111111122111111111111111111111111111111112221111111111111111111111111111111111111111111111111111111111311111111111131111111
12221111111111111111111112111111111111111112222111111111111111111111111111111111311111111111111111111111111111111111111122111111111111111111111111111111111111111311111111111111111111111111311111111111112221111111111111111111111111111111122211111111112111111111111111111111111111111111111111111111111111111111111111111111
12222111111111111111111221113111111111111111222111111111111111111111111111111111111111121111111112113111111111111111111111111111111111111111111111111111111111111221111211111111111111111111111111111111122211111111111111111111111111111111122111111111111111311111111111111111111113111111111111111111111111111222111111111111
11222111111111111111112211111111111111111111111111111111111111211111111111111111111111121111111122111111111111111111111111111111111112222221111111111111111111111121111211111111111111112211111111111113111111111311112111111111111111111111111111111111111111111121111111111111111311111121111111111111111111112221111111111111
11122111221111111111111111111111222112221111111111111111111112221111111112211111111111111111111121111111111122111111111111131111111112222221111111111111111111111111111111111113111111112221111111111111111111111111122221111111111122222221111111111111111111111121111111111111111111111123111111111111111111122211111111111111
11111111221111111111111111111112222112211111111111111111111122221111111111111111111111111111112211111111111221111111111111111222111111222211111111111111111111111111111111111111111111112221111111111111111111111111112221111111111221222221111111111111111111111111111111111111112111111122211111111111111111112111111111111111
11111122111111111111111111131112222222111111111111111111111112221111111131111111111111111111122211111111122111111111111111111222111111111111111111111111111111111111111111111111111111111231111111111111111111111111111111112222222311122221111111111111111111111111111111111111111111111122221111111111111111111111111111111111
11111222111111111111111111111111121222111111112211112111111111221113111111111111122111111111222111111111222111111112211111111122111311111111311111111111211111111111111111131111111111111111111111111111111111111111111111122222222111112211111111111111111111111111111111111111111111111122221111111111111111111122111111111111
11112221111122111111111111111111111111111111111211122111111111121111111111111111111111111111121111111112221111111122211111111111111111111111111111111111111111111111111111111211111111111111111113111111111111121111111111122112222111111111111111111111111111111111113111111111111111111112211111111111111111111112111122111111
11112221111122211111111111111111111111111111111222211111111111121111111111111111311111111111111311111112211111111122111111111111111111111111111111111111111111111111111111111211111111111111111311111111111111111111111111222112221111111111111111111111111111111121111311111111111111111111111111131111111111111111111122211111
11122111111112211111111111111111111111111111111222211111111111221111111111111111111111113111111111111111111111111111111111111111121111111111111111111111111111111111111111111111111111111113111111111111111111112211113111111111111111111131111111111111111111111111111111111111111111111111111111111111111111111111113122211111
