TILEMAP
3200 58
16 32
images/blocks_moon.png
2 2
                                                                                                                                                                                                                                                                                                                                
                                                                                                                                                                                                                                                                                                                                
                                                                                                                                                                                                                                                                                                                                
                                                                                                                                                                                                                                                                                                                                
                                                                                                                                                                                                                                                                                                                                
                                                                                                                                                                                                                                                                                                                                
                                                                                                                                                                                                                                                                                                                                
                                                                                                                                                                                                                                                                                                                                
                                                                                                                                                                                                                                                                                                                                
                                                                                                                                                                                                                                                                                                                                
                                                                                                                                                                                                                                                                                                                                
                                                                                                                                                                                                                                                                                                                                
                                                                                                                                                                                                                                                                                                                                
                                                                                                                                                                                                                                                                                                                                
                                                                                                                                                                                                                                                                                                                                
                                                                                                                                                                                                                                                                                                                                
                                                                                                                                                                                                                                                                                                                                
                                                                                                                                                                                                                                                                                                                                
                                                                                                                                                                                                                                                                                                                                
                                                                                                                                                                                                                                                                                                                         1      
                                                                                                              111                                                                                                                                                                                                       11      
111                                               1             111         11                                11111111     11                                        11                                                   111                        111              111                                 111           11      
1111       11 11111111                      1111111          11111111  11111111                               11111111    111    11111111            111    1111111  11                             111111                1111111           11       111             11111   11111111                     111           11      
1111     1111111111111              1111    1111111          1111111111111111111111111111111             111  111111111 11111111 11111111     111 111111    11111111 111         1      11         11111111   11111111111 21211111          11     111111 1111111111111111   1111111111111         111    11111111111   1111    
111111111111111111111111    11   1111111 1111111111 11       11111111111111111111111111111111111111111 111111111111111111111111111111111211111111 111211    111111111111        11111 111111111   11111111111111111111111111111111111  1 111111    111111111111111111111111  1111111111111111    111111  1111111111111  111111  
111111111111111211111111111 11  11111111111111111111111111111111111111111111111111111111111111111111111111121111111111111111111111111111111111111111111111111111111111111  11111111111111111111  1112111112111111111111111111112121111111111111   1111211121111111111111111 121111111111111111111111111111111111111111111111111 
1111121111111211111112211111111 111111111111111111111111111111111111111111311111111111112111111111111111111111111111111111111111111111211111111111111121111111111121111111111111111111111111111111111111111111111111111111111111111111111111111   11111111111111121111112111111111112111111111111111111111111111111111111111111 
1111111111111111111111111211121 111211111111111111211111111111111111111111111111112111111111111211111111111111211111111111112111122111111111111111111111111111121111111111111111111113111111112111111111111111111111111111111111111111111111111   11111111111111111111111111111111111111111111111111111111111111111111111111111 
11111111111111111111111111111111111111111111111111111111131111111111111111111111111111111111111111111111111111111111111111111111111111112111121111111111111121211111111111111111111111111111111111111111111111111111111111111111111211111111111 11111111111211111111111111111122111121111111211111111111111111111111112111111111
11111111111111111111111111111111111111111111111111111111111211111111111111111111111211113111111111111111111111111111111111111111111111111111111111211111112111111111111111111111111111111111111111111111111111111111121111111111111111111111111 11111111111111111111111111111112111111111111111111111111111111211111111111111111
11111111111111111113111111211111111111111111111111111111111121111211111111111111111111111121111111111121111111111111111111111111111111111111211112111111111221111111111111111111111111111111111121111111111111111111111111121111111211111111111111111111111111111111111111211111111111111111111111111111131111111111111111111111
11111111111111111111111111111111111111111111111111111211111111111111111111111111112111112111111111111111111111111111111111111111111111111111121112211111111111111111211111111111111111111111111111121111211111111111111212111112121111111111121111111111111111111111111112111112111111221111111112111211211211111111111111111211
11121111111111111111111111111111111111111111111111211121111111111121111121111111111111111111111112111112111111111111111111111111111111111111111111111211112111111121111111111111111111111111111111121111111111111111111111111111121111111111111111211111111111111111111111111211111111111111111111121112121111111111111211111111
11111111111111111111111111111111111111111111111111111111111211111111111111111111111111111111111111111121111111121111111111111111111111111111111111111111111111121111112211111111112111111111111211111111111111121111221111111111111111111111111211111111111111111121111111111111111111111111111111111111111111211111111121111111
11111111111111111111111111112111111111111111111112111111111111111111111111111121111111111111111111111121111111121111111111111111111111111121111111111111111111111111111111111111111111111111111111111111111111111111111111111111111111121111211111121111221111111111111111111111111111211111111111111111111111111211111111111111
11111111111121111111111111111113111111111111111121111111211111111111121111111111111111111111111111111212121111111111111111111111111221111111111112111111111111111111111111111111121121111111112111111111111111111112112111111111111111111111111111111111211111111111111211111111111111111112211211121111111111111111112111111121
11111111111111111111111111111121111111111111111111211111111111111121111111111111111111111111121211111111111111111111111111111111111111112112111111111111111111111111211112111111111111121111111111121111111112111111111121111111111111111111211111111111111111111111111111211111111111112111121111111111111111111111111111111111
11111111111111111111111111111122112111111111111111111111111111111111111111111111111111111111112111111221113111111111111111111111111111111111111112111111132111111112111111111111111111211111111111111111121111111111111111111111111111111211111121111111112211111111111112111111111111111111111111111111111111111111111111111111
11111311111111111111111111111111111111111111111211111111111111111111111111111111111111121111111111111111111111111221111111111111111121111111111111112111111111111211111111111111111111122111111111111111111111111111111111111111121111111111111111111111121111111111111111111111111111111112111111111111111111111111111111121111
11221111111111111111111111111111111111111211111111111111111111111111111111111113121211111111111211111111111111111111111111112111111111111111111111111111111111111111111111111111111111111111111111111111111111111111111111111111111111111211111111111111111111111111111111111111111111111111112111111111112111111111111111111111
11111111311111111211111111111111112111111111111112111111111111111111112111211111121111111111111111211111111111111111111111111111111111111112111111111111111111121111111111121111121111111111112111111111111111121111211121111111111111111111111111211111111111111111111111111111112111111111111111111111111111111211211111111111
11111111111111111111111111111111111111111122111111111111111111111111111111111111111111111111111111111111111111111211111121121111111111111111111111111111112111111111111111111111111111111111111111121112111111111111111111111111111111111111111111111111111111111111112111111111111111111111112111111112111111111111111111121111
21111111121111111211111111111111111111111111111211111111111121111111211111111111111111111112111111111121111111111211112111211111111121111111111211111111111111111111111111111111111111111111111111111111111111111111211111111121111111111111111121111211112111211111111111111111111111111111111111111111111111112111111111211111
21111111111111111111111111111111111112111111111111111211111111111111111111111111111111111121111111111111111111111111111111111111211111111111111111111111111221121111111111213111111111111211111111111111121111111111111121111111211111111111111111111111111111111111111111111111121111111111111111112112112111111111111111112111
11111111111111111111111111111111111121111111111111111121111111111111111111112111111111111211111111111111111111111121111111111111111111111111111121111111111111111111111111111111112111112111111111111111111111111111111111111111111211111211111112111111121111111111111111111111111111111111111111111111111111111121111111111111
11111211111111111121111111111111111111111111111311111111111111111111111121111111111111111212121111111111111111111111111211112111111211111111111111111111111111111111111111111111112111111111111111211111111121111111111121111111111111112111111121111111111111111111111111111111111111111111111111111111111311121111111112111111
11112111211211111111111211111111111111111111112111211121111111111111111111111111111111211111121111111111111111111111111111111121111111111111111111111113121111111111111111211111111111111111111111111111111121111111111111111111111111111111111111111111111111111221111111121111111111111111111211111111111111121111111111111111
11111211111111111111111111121111111113121111111111111121111112111111111111111112111111311111111112111121111111111111111111111111111212112211111111211111111211111111111111111211112111111111111111111111111111111111111111111111111111111111111111111111111111111111111111112111111211111111111111111111211111121111111111111111
11111121211111111111111111111211111111112111111111111111111111111111121111111111111111131111111111111111111111111111111111111111111111112111111111111211111112111111111111111111111111111211111111111111111111121111111111111111112111111111111111111111111111111211111111111111111111111111111111111111111121111111111111111111
11111111111111111111111121111111111111111111111111111111111111111211111111111111111111111111111111131111111111111111111111111111121111111211111111111121111111111111111111111112111111111111112111112111121111111111111111111111111111111111111111111111111111111111111111111111111112122111211211111111111111111111111111111111
11111111111111111111111111111111111211111211111111111111111111211111111111111111111111111111111111111111111111111111111111111111111111111111111211111111111111111111111111111111111111111111111111111211113111111111212111111111111111111111111111111111111113111111111111111111111112111111121111111111211111111111111111111111
11111111111111111111111211111121111111111111111111111211111121111111111111111111111111211111111111111111111111222111111111121111111111111111211111111111211111111111111111111111111111111211311121111111111111111111111111111111211111111111111111111111111111111111211111111121111111111111111111121212112111112111112111111211
11111111111111111111111111111111111111111111111211111111111111111111111111211111112111111111121111111112111111111111111111111111111112111111111111111111121111111111111111111111211112111111111212111111111111111111111111111111111111111111111111121121112111111111111111111111121111111111111111111111111111111111111111111111
11111111111111111111111112111111111111211111111211311111111111111111111111111221111111111111121111111111111111111121111111111111111111111111121111111111111111111111111111212111111111111111111111111111211111111111111111111111111111111111111111111111111111111111122111111121121111311112111111111111111111111111111111111111
11211111111111111111111111111111111111111111111111112111111111111111111111111111211111111112111111111111111111111111111111111111111111111111111121111111111111111111111111111111111111111111111111111112111111111111111111111111111111111111111111111111111111111111111111111111111111111111111111111111111111111111111111111111
12111111111111111111112111111111111111111111111111111111111121111111111111111111111111111111111111111111111111111111111111121111111111111111111111111111111111112111121111111121111111111121121111111111111111111111111111111211111111111111111111212111111111111111111111111111111111111111111111111111111111111111111111111111
11111111111111111111111111111111211111121111131111111111111111111111111111121111111111111211111111111111111111111112112111111111111111111111122111111111111111111111111111111111112111111111111111112111111111111111111111121111111111111121111111111111112211111111111111211111111111121111111111111111111211111111221111111111
11112111121121111112111111111111121111111111111111121111111111111111111111111111111111111112111111111121111111111111111111111111111111111111111111111111111111111121111111211111111111111111111111111111111111111111111111111111111111111112111111111112111111111111211111111111111111111111111111111111111111111212111111111121
