TILEMAP
320 58
16 32
images/blocks_moon.png
2 2
                                                                                                                                                                                                                                                                                                                                
                                                                                                                                                                                                                                                                                                                                
                                                                                                                                                                                                                                                                                                                                
                                                                                                                                                                                                                                                                                                                                
                                                                                                                                                                                                                                                                                                                                
                                                                                                                                                                                                                                                                                                                                
                                                                                                                                                                                                                                                                                                                                
                                                                                                                                                                                                                                                                                                                                
                                                                                                                                                                                                                                                                                                                                
                                                                             1                                                                                                                          1111                                                                                                                    
                                                     1111               11111111111                                                                                                                  111111111                                                                                                                  
                                                   11111111          11111111111111111111                                                                                   111           11111    11111131211111                                                                                                               
                                     11111111    1111122111111    11111111111111111111111111111                                                                           11111111     1111111111111111111111211111111111111111111                                                                                              
                                    111111111111111111111111111111111122111111111111111111111111111                                                    111111111         1111111111111111111111111111111111111111111111111111111111111                          111                                                             
                                  1111111111111111111111111111111111111111111111122111111111111111111           1111                               111111111111111     1112221111111111111111111211111111111111111111111111111111111111111            1111111111111111                                           11111111       
                                11111111111122211111111111111111111111111111111222221131111111111111111       11111111              11111111     11111111111111311111111122221111111111111111112221111111111111221111111111111111111111111111111111111111111111111111111                                1111111111111111111     
                              111111111111112221111111111111111111111111111111222222211111111111111111111   111111111111         11111111111111111111111111111111111111111111111111111112111111122211111111111111111111112221111111111111111111111111111111111111111111111     1111111111111111      11111111111111111111111111 
                           11111111111111112211111111111311111111111111111111112222211111111111111311111111111111111111111111111111111111111111111111111111311111111111111111111111111111111111122111111111111111111111122221111111111111111111222111111111111111111111111111111111111111111111111111111131111111111111111111111
                         1111131111111111221111111111111111111111111111111111111111111111113111111113211111111111111111111111111111111111111111111111111111111111111111111111112211111111111111111111111111111111131111122211111111111111111111121111111111111111111111113111112111111111111111111111111111111111111111111222111
              111   111111111111111111111221111111111111111111111111111111111111111111111111111111122111111111111111111112211111111111111111111122221111111112111111131111111222211111111111111111111111111111111111111111111122222211111111111111111111111111111111121111111222211111111111111111111111111111111111111112222211
           111111111111111111111111111111111111111111111111111111111111111111111111111111111211111221111111111111111111111111111111111111111111222222111111111111111111111111221111111111111111111111111111111111111111111111122222211111111111111221111111111111111111111111222211111211111111121111111111111111111111222222211
          1111112111111111111111121111111111111111111111111113111111111111111111111111111111111111111111111112111111111111111111111112111111111222222111111111111111111111111211111111112111111111111111111111311111111111111112221111111111111111111111111111111111111111111222111111111111111111111111111111111111112222222211
         11222222111111111111111111111111111111111211111111111111111111111111111211111111111111111111111111122111111111111111111111111111111111111122111111111111111111111111111111111112111122111111112211111111111111111111111111111111111111111111111111111111111111111111221111111111111111111111111111111112111112221122221
        111121222111111111111111111111111111111111211111111111111111111111111111111111111111111111111111111221111111111111111111111111111111111111111111111111111111111111111111211111131111111111111111111111111111111111111111111111111111131111111111111211111111111111122111111111111111111111111111111111111111122111112222
      11111111111111111122211111111111111111111111111111111111111111111121111111111111111111111111111111122211111111111111111111111111111111111111111111111111111111111111111111211111111111111111111111111111111111111111111111111111111111111111111111111111112211111111121111111111111111111111111111111111111111221113112222
    1111111111111111311122221111111111111111111111111111111111111111111111111111111111112111121131111111222111111111111111111112111111111111111111111111111111111121111111111111111111111111111111111111111111111111111111111111111111111211111111111111111111111111111111121111111112211111111111111111111111111112211111111222
11111111111111111111111122222111111111111111111111111111111111111111111111111111111111111111121111111111221111111111111111111122211111111112111111111211111111111111111111111111111111111111111111111111111111111111122111111111111111112221111111111111111111111111111111111111111122211111211111111131111111111111111111111111
11111111111111111111111111111211112211111111122222211111111111111111111111111111211111111111111111111111111111111111111111111122221111111111111111111211112211111111111111111111111111111111111111111111211111111111111111111111111111112222111111111111111111111111111111111111111222111111111111111111111221111111111111111111
11111111111111111111111111111111112221111111111222211111111112111121111111111111211111111111111111111111111111111111111111111122222111111111111111111111111111111111111111111111111111111111111111111111211112211111111111111111111111111221111111111111111111111111111111111111111121111111111111111111131111111111111111111111
11111111111111111111111111111111112221111111111222211111111112111111111111111111111111111111111111111111111111112111121111111112222111111111111111111111111111111111111111111111111111111111111111111111111122211111111111111111113211111111111111111111111111111111111111111111111111111111111111111111111111311111111111111111
11111112111111111111111111111111111222111111111122111111111111111111111111111111111111111111111111111111111111111111121111111111222111111111111111111111111111211111111121111111111111111111111111111111111222111111111112211111111211111111111111111111111111111111112211112111111111111111111111111111111111111111111111111111
11111111111111111112111111111111111222111111111111111111111111111111111111111111111111111111111111111111111111111111111111111111111111111111111111111111111111111111111222111111111111111111111111111111111221112211111112221111111111111111111111111111121111111113111111122211111111111111211111111121111111111111111111111111
11111111111111111111111111111111111222111111111111111111111111111111111111211111111111111111111111111111111111111111111111111111111111111111111122111121111111111111111222111121111221111111111111111111111111111211111112221111111111111112111111111111111111211111111111122221111111111111111111111121111111111111111111111111
11111111111111111111111111111111111222211111111111111111111111111111111111111111111111111112111111111111111111111111111111111111111111111111111111111121111111111111112222111111111111113111111111112221111111111111111111111111111111111112211122111111111111111111111111112221111111111111111111111111111111111211111111111111
11111111111111111111111311111111111122211111111111111111111112211111111111111111111111111112111111111221111111111111111111131111111111111111111111111111111111111111112222111111111111111111111111112221111111111111111111111111111111111111111222111111111111111111111111111111111111111111111111111111111111111111111111111111
11121111111112111111111111111111111111111122111111111111111222211111111111111111111111111111111111112111111211111111122111121111111111111111111111111111111111111111111222111111111111111111111111111221111111113111111111111111111211111111112221111111111111111111111111111111111111111111111111111111111111111111111111111111
11111111111122211111111111111111111111111221111111111111112221111111111111111111111111111111111111121111111111111111111111111311111111111111111111111111111111111111111121111111111111111111111111111111111111113211111111111111111111111111112221111111111111111111111111111111112111111111111111111111111111111111111111222221
11111111111111111111111111111211111111122111111111111111111111111111111111111111111111111131111112221111111111111111111111111111111111111122111111111111111111111111111111111111111221111111111111111111111111111221112211111111111111111111111111111111111111111111111111111111122211111111111112211111111121131111111111122222
11111111112211111111111111111111111111222111111111111111111111111111111111111111111111111111111112211111111111111111111111111111111111111222211111111122111111111111111111111111111111111111111111111111111111111131111111131311111111122211111111111111111111111111111111211111112211111111111111111111111121111111111111112221
11111111122211111211111111111111111111222111112211111111111111111111111111111111111111111111111112111111111111111111111111111111111211111222211111111111111111111111111111221111111111111111111111111111111111111111111111111111111111122211111111111122222231111111111111111111112211111111111111111111111111111111111111111211
11121111222111111111111111111111111111221111112221111111111111111112211111111111111111111111111111111111111111111111111111111111111131111122222111111111111111211111111112221111111111111111211111111111111111111111111111111111111111112211111111111222222221111121111111111111111111111111111111131111111111111111111111111111
11121111221111111111111111111111111111111111112221111111111111111112221111111111111111111111111111111111111111111111111111111111111111111111111111111111111112222222111112221111111111111111111131111111111111111111111111111111111111111111111111112221222211111111111111111111111111111111111111111111111111111111111111113111
11111111111111111111111112111111111111111111111111111111111111111112221111111111111111111111111111111111111111111111111111111111111111111111111111111111111112112222111111111111111111111111111111111111111111111111111111111111111111111111111111112211122311111111111111111111111111111111111111111111111111111111111111111111
11111111111111111111111111111111111111111111111111111111111111111111221111122111111111311111111111111111121111111311111112111111111111111111111111111111111221111222111111111111111111111111111111112111111111111111111111112211111111111111111111111111111111111111111111111111111111111111111111111112211111111111111211111111
11111111111111111111111111111111111111111111111111111111221111211111111111111111222111111111111111111111111111111111111111111111111121111111111111111111112221111111111111111111111111111111111111113111222111111111111111112221111111111111111111111131111111111111111111111111111111111111111111111111111111111111311111111111
11111111111111111111111111111111121111111111111111111111121112211111111111111111122231111111111111111111111111111211111111111111111221111111111111111111122211111111111111111111111111111111111111112222211111111111121111111221111111111111111111111111111111111221111131111111111111111111111211111111111111121111111111111211
11111111111111111111111111111113111111111111211111111111122221111111111111111111122211111131111111111111111111111111111111111111111211111111111113111111112111111111111131111111111111111112211111112222111311111111111111111221111111111111111111111111111111112221111121111111111111111111111111111111111111121111111111111111
11111111111111111111111111111111111111111111111111111111122221111111112111111111111111111111111111111111111111111111111111111311222111111111111111111111111111111111111111111113111111311122211111112222111112111111111111111111111111111111111111111111111111122211111111111111111111111111111111111111111111111111111111111111
11111113111111111113111111111111111121111111111111111111122211111111112111111111111111111111111111222111111111111111111111111112221111111111111111111111111111111111111111111111111111111122221111112221111111111111111131111111111111121111111111111111111111122111111111111111111111111111111111111111111111111111111111111111
11111112111111111211111111111111111121111111111111111111122211111111111111111113111111111111111111222211111111111111221111111112221111111111111111111111111111111111311111112111111111111222211111111211111111111111111111111111111111121111221111111111111112111111111111111111111111111121111111111111111111111111111211111111
11111122211111111111131111111111111111111111111111112111121111111111111111111111111111111112211111222221111111111111222111111111111111111121111111112111111111111111111111112111111111112211221111111111111111111112213111111111111111122112111111111111111122111111111111111111111111111121111111111111111111111111112221111111
11111112221111111111111111111111111111111111111111111111111111111111111112111112111111111122211111122221111112111111222111111111131111111121111111122111111111111111111111111111111111122111221111111111111111111122211111111112111111122221131111111111111111111111111111111111111111111111111111111111111111121111122211111111
11111112221111111111111111111111111111111111111111111111111111111111111111111112111111111122111111112221111111111111122111111111111111111111111111122111111111111111111111111111111311111111121111111111111111111122211111111111111111122221111121111111111111111111111111111211111111111111111111111111111111111111113111111111
11111112221111111112221111111112111112211111111111111111111111111122211111113111111111111111111111111211111111111111122111111111111111111111111111221111111111111111111111111111111111111111111111111111111111111221111111111111111111122221111111111111111111111111111111111311111111111111111111111111111111111111111111111111
11111112221111111122222111111111111112222221111111111111311111111122211111111111111111111111111111111111111111111111222111211111111111111111111111211111111111111121111111111111111111111111111111111111111111122111111111111111111111112211111111111111111111111111111111111111111111111111111111122111111111111111111111111111
11111112221111112222222111111311111112222221111111111111111111111112211111111111111111111111111111111111111111111111111111211111111121111112211111111111111111111111111111111111112111111111111111111111111111122111111111111111111111111111111111111111111111111111111111111111111122111111111111122211111111111111111111111111
11111111221111122222222111111111111111222111111111111111111111111111111311111111111111111111111111111111111111111111111111111111111111111112221111111111122111111111111111111111112111111111111111111111111111111111111111121111111111111111111111111311111111211111111121111111111222111112211111122211111111112111111111131111
11111111111111122222222111111111111111111111111311111111111111111111111111111112211122111111111211111111111111111111111111111111111111111112221111111111122111111111111111111111111111111111111111221111111111111111111111111112221111111111111111111111111111111111111111111111111221111112221111122211111111122211111111221111
