TILEMAP
320 58
16 32
images/blocks_moon.png
2 2
                                                                                                                                                                                                                                                                                                                                
                                                                                                                                                                                                                                                                                                                                
                                                                                                                                                                                                                                                                                                                                
                                                                                                                                                                                                                                                                                                                                
                                                                                                                                                                                                                                                                                                                                
                                                                                                                                                                                                                                                                                                                                
                                                                                                                                                                                                                                                                                                                                
                                                                                                                                                                                                                                                                                                                                
                                                                                                                                                                                                                                                                                                                                
                                                                                                                                                                                                                                                                                                                                
                                                                                                                                                                                                                                                                                                                                
                                                                                                                                                                                                                                                                                                                                
                                                                                                                                                                                                                                                                                                                                
                                                                                                                                                                                                                                                                                                                                
                                                                                                                                                                                                                                                                                                                                
                                                                                                                                                                                                                                                                                                                                
                                                                                                                                                                                                                                                                                                                                
                                                                                                                                                                                                                                                                                                                                
                                                                                                                                                                                                                                                                                                                                
                                                                               111111                                                                                                                                                                                                                          111              
                1                                                1             111111                        1111                                                                                                                                    111                       1111                          1111111111         
   1111       1111            1              111111              11            1112111        1111          1111111       111111            111          111             111                                                1      1              111111                       1111 11111   11111111111      11111111111        
   1111      11111            11111111    1111111111111         11111111111111 11121111    1111111          1111111       111111           1111          111111      111111111                       111            11  1   111111111111111      111111111                     1111111111  111111111111     11111111112111111111
  111111     11111  1111111  111111111111111111111111111111111111111111111111111111111111 111111111         1111111       111111    1      1111   1111111111111 11  1111111111            11         111111       11111 1 1 1111111111111111   111111111111      1           111111111111 11111111111111 11111111111111111111111
  1111111111111111111111111111111111111111111111111111111111111111111111111111111111112111111111111 1       1111111      11111111111111111111111111111111111111 11111111111111          111111       111111      1111111111111111111111111111  1111111111111     111111111111111111121211111211112111111111111111111111111111111
 111111111111111111111111111111111111111111111111111111111111111211111111111111111111111111221111111111111111111121     11111111111111111111111111111111111111211111111111111111     1111121111    11111211      11111111111111111111111111111111111111111111    111111111111111111111111111111111111211111111111111111111111111
111111111111111111211111111111111111111113111111111111111111121111112111111111111111111111111111111111111111111111111  111111211111111111111111111111112111111111121121111111111111111111211111111111111111     111111111111111111111111111221111111111111111   1111111111211111111111111111111111111212121111111111111111111111
11212111111111111111111111111111111111111111111111111111111111212121111111111111111111111311111111111111111111111111111111111111111111111111111111111111111111111111111111111111111111111111111111111111111  1111111111111111111111111121111121111111112111111111111111111111111111212113111111111111111111111111111111111111111
11111111111111111111111111111111111111111211121111111111111111111111111111112111111111111111111111111111111111111111111111111111111121111111111111111111111112112111111111111111111111111111111111111111111111111111111111111111111111111111211111111111111111111111111111111111111111111111111111111111111111111111111112112112
11112111211111111111111111311111111111112111111111111111111111111121111111111212111111111111111113111111111111111111111111111111111111112111111111111111111112111111111111111111111112111111111111111111111111111111111121111111111111111112111211112111111111111111111121111211111111111121111111111111111111111111112111111112
11111111111111111111111111111111111111111111111111111111111111111111111111111111111121111112111111111211111111111111111221111111112111111111111111111111111111111111111111111111111111111111111111111111111111111111111111111111111111111111211111211111111111111111111111111112111111111111111111111211111111111111111111111111
11111111111111111111111111111111111111111121111111111111211112111111111111111111111111111111111131111111111111111111111111111111111111111111111111112111111111111121111111121112111111111111111111211111111111111111111111111111111111112311111111111111111111111211111111111111111111111111111111111111111111111111111121111111
11111111111111111111111111111111111111111111111111111111111111111111111111111111311111111111111111111111111111111111111112111111111111211111111131111111111111111111111111111111111111111111112211211111111111111111111111112111111111121111111111111111111111111121111111112111111111111111312111111111111111121111111111111111
11111111121112111111111122211111111111111111211111111111111212121111111111112111111111121112111111211111111111111121111211111111111111111111111111111111111111111111211111111111211111111111211111111211111111111111111111111111111111111111311111112111112111111111111111111111111111111111111111111211111111111111111111111111
11211111111111121111211211111111111111111111111111111111111111111111111111111111111111111111111111111111111111111112111111111111111111111111111111121111111111111111111111111111111121111111111121111111121111111121111111111111111111111111111111111111111112111111111111112111111111111111111221111112111111111111111111111111
11111111111111111111111111111111111111111111111111111111111211111111111111111111111111113111111111111111111212111111111111111112111111111112111111111111111111111111111111111111211111111121111111111111111111111121111111111211111111111111121111111111111111111111111111111111121111111111111111111111111111111111111111121111
11111111111111111111111111111111111111111111111111111111111111111211112111112211111111121111111111211111121111111111111111111111111111112111111111211111111111111111111112111111111111111111111111111111111111111111112111111111111111111111111111111111111111111111111112112111111111111111111111111111111121111111111111111111
11111111111111111121111221111111111111111111111111211111111111111131211111111111111111111111311111111111111111111111111111111111111111111122121111111111111111111111111111111111111111111121111121111111111111111111111111111112111111111111111111111111311111111121121111111111112111111111111111111111111111111121111111111111
11111111111111111111111121111111111111111211111111111111111111111111111111111111111111111111111111111111111111111111111111111121111111112111111111111111111111111211111112111111112111111111112111111111111111111111111111111112111112111112111111111111121112111111211111111121111111111111111131121111112111111111111211111111
11111111111111111111112111111211111211112111111111111111111111111111111121112111111211111111211111112111111111111111111111112111111111111111121111111111111111111111121111111111211113211111111111111111111121111111111111111111121111111111211111111111111121111111111111112111111111111111111121211111111121111111111111111111
11311111111111111121111111111111121121111111111111111111111111111111111111111111111121111111111111111111111111211121211111111111111111111111111111111112111111111111122111111111111111112111111111111111111111111111111111111111111111111111111111111111111111121111112111111111111111111111111112111111121111111111111111111111
11111111111111211111121111111111111111111111111111111111111111111111111111111111111111111111111121111111111121111111111111111111112111111111111211121111111111211111212111111111111121111111111121111111112111111111111111111211111111112111121121111111111111111111111111111111111111111111111111111121111111111111111111111211
11111111112111111111111111111111111111111111111111111111122111111111111111111112111111111111111111111111111111121111111112111111111111111111111111111111211111211111111111111111211311111111111111112111121111111121111111111111111111111111111111111111111111111111111111111111111111111111111111111111111112111111111111111111
11111111111111111111111111111111111111111111111111111111111111111111111111112212111111121111111111111111111121111111111111111121111111111111111111111111111111111211111111111111111121111211111111111111111111111111111111111111111111111111211111111111111111111111111211111111111111111111111111111111111111111111111111111111
11111111111111111111111111111111111111111111111111111112121111111111111111112111113111111111113111111112111111111211111111111111111111111111211111111111111211111111111111111111211111111111111211111111111111111111111111111121111111111111111112111111111111111111111111111111111111111111111111111111111111111111111111111111
11111111111111111111111111111111111111111111111111111111111111111111111112111111111111111111111111111111111111112111111121111111111111111211111111111111111111111111111121111111111111112111111112111211111111111111111111111111111111111111111121112111111211111111111111111111111111112211111111111111111111111111111111111111
11112111111112111111111111111111111112111111111111111111111211111111111111111111111111111111111111111112111111111111111111111111111111111111111111111111111111111111111111111111111111111111111111111111111121111111111111111112111121111211111111111111111111111111111111112111211111211111111111111111111121111111111111111111
11111111111211111111111111111111111111211111111111111121111111121111111111111111121111111111111111111111111111111111111111111111111111111121111111111111111111111111111111111111111111111111111111111111111111111111111111111111111211111111111111111111111121111111121111111111111111121211111111111111111111111111111111111112
11111111111111111111111111111111111111112111111111111111111111111111111111111111111111111111111111111111111111111111111111111111111111111111111111111111111111111211111111111111111111111111111111111111111111111121111112111111111111111111111111111111111111111211111121111111111121111111111111111111111111111111111221111311
11111111111111211111211111111111111111111111112111111111111111111111111111112211112111111112211111111111121111211111112111111111111111111111111111111111111111111111111111111111111111112111111211111111111111111211111111111111111121111121211121111111111111111111111121111111121212111111121111111111111111111111121111121111
11111111111111111111111111121111111111111121111111111111111111111111111111111121311111111111111111111111111111111111111111111111111111211111111111111111111111111121111111112111111111111111111111111111111111111111111112111111112111111111111111111111111112111111111111111111211111121212111111111111111111111112111112111111
11111111111111112111111111111111111111111111111211111111111111111111111111111111111111221111111111111111111111111111111111111111113111111111111111311111111111111111111111111111111111111111111121111111111111111111111111111111111111111111111111111111111111111211111111111111111111111111111111111111121111112111111111111111
11111111111111111111111111111111111113111111111111111111111211111111121111111113122111111112111111111111111111121211111121111111112111111111111111111111111121111111111111111111111111111111111121111111111111111111121111211111111111111111111111111111111211111111111111111111111111111111111111111111111111111111111111112111
11111111111111111111111111111111111111111111111111111121111111111111311111111122111111111111111111111111111111111111111211111111121111111112111111111111111111111121111111112111111111111121111111111111111112111111111111111111111111111111111111111111121111111111111111112111111121111111111112111111111111111111111121111112
11111111111111111111111112121111111111111111111111111111111111111111111111111111111111111111111111111111111111111111111111111111111111111111111111111111111111111111211111111111113111211111111111111111111111111111111111121111111121111111111111111111111111111111121111113111112111111111111111111111111111112111111111111211
11111111111111111111111111111111111111221111111111111111111111111111111111111111211111111111111121111111111111111111111211111111111111112111111111112111111111121111211211111111111111111111111111111111111111111111111211111111112112111111111111111111111111111111111111111111111111111111111121111121111111111111111111111111
11111111111111111111111111112111111121111111111111111111111121121111111111111111111111111112111111111111111111111111111111111111111111111211111112111111111111111121111111112122111111111111111211111111111111111111121111111112111111111111111111111111111111111112111111111111111112111121111111111111211111111111111111111111
11111111211111111111111111111111111112111111111111111111111111111111111111111111111111121111111111111111111121111111211111111111211111111121111111111111111111111111111111111111111111112111111111121111111111111111111111111111111112111111111111111111111111121111111111111111111111111111112111111111111112111211111111111111
