TILEMAP
200 64
16 32
images/blocks_moon.png
2 2
                                                                                                                                                                                                        
                                                                                                                                                                                                        
                                                                                                                                                                                                        
                                                                                                                                                                                                        
                                                                                                                                                                                                        
                                                                                                                                                                                                        
                                                                                                                                                                                                        
                                                                                                                                                                                                        
                                                                                                                                                                                                        
                                                                                                                                                                                                        
                                                                                                                                                                                                        
                                                                                                                                                                                                        
                                                                                                                                                                                                        
                                                                                                                                                                                             1     1111 
                                                                                                                                                                                          1113    111111
                                                                                                                                                                                       1111111   2111111
                                                                                                                                                                                        21111   22211111
                                                                                                                                                                                              1122211111
                                                                                                                                                                                 11          11222111 11
                                                                                                                                                                                111          122211    1
                                                                                                                                                                              111111        122211      
                                                                                                                                                                    111    111111111       122221       
                                                                                                                                                                   1111    111111311      312211        
                                                                                                                                                            11     11111  211111111      122111         
                                                                                                                                                  2     211111     1111122211111111     112211      1111
                                                                                                                                               1111                111112221111111     11112111     1111
                                                                                                                                              11111            111113111222211111     111112211    11111
                                                                                                                                              11111           111111   112221111      1111122211   11111
                                                                                                                                              11111           111111     122111      11111222211        
        1                                                                                                                               11111111111          1111111      11111      1111122211         
111     111                                                                                                                            1111111111111          21111        11221     111112211          
111      111111                                                                                                         111      11112211122111111111                       223111    1122111           
111         111111                                                                                                 11111111     1111111111111111111111                      221111     12111            
11           11111   2                                                                                   111111111111111121     1111111111111  11111111111121                 1111     111111    111   1
               111    11                                                                               22  1111111111111222     111111111111     1111111111111                1111      111111  1111    
                                                                                                            111111111111222     11111111111       111111111111                  11      111111111111    
   111112                                                                                                   1111        1222   11311111111        1111 11111111                         111111111111    
   111111            1     111111                                                                           1111         111    111111111                 11111    1111111               11111111111    
   111111           111    11111       11                                                     11131         1111         1111   11111111           1       1111    1112111111                  11111    
    1111           11111   2111         111                                                    11111        111          1111     11111      111111111     1111    1111111111111                        
                  111111   111           111                                                   111111       11           1121     111111    1111111111     1112   111111111111111111112                 
         11111   1111111  111             11112                      1111  1111 1111           111111                    1122      1111111 111111111111    1111  1111111111111111111111                 
        111111111111111  11111             1111111       11111111   1121111111111111     1111121111111            111    11111      111111111111111111111 111111111111         11111111       11       1
2     111111111111111    11111111112          1111      1111131111   11111  11111111     1111111111111           11111   11111111    1111111      1111111111111111111            11111      211111     1
11111111111111111        11111111112           111     11111111111    11    11111111     1111111112211          111111    11311111     11111        1111111111111111                1      22111111   11
11111111111111111        11111131112           1111   12221111111           11111111    111111111122211        111111     11111113      111              1111111111                       122111112    1
11111111111111111        11111111112           11111 112221111111           12221112    1111111111222111111111111111      11111112       1                11111111                       11111111122   1
   11111111 11111        1111 13111            11111 11221  12111           22221       111111111112211112111111111      111                    311                                     111111111112    
     11111   1111      1111    11112           1111   111   22211111112     2221         111111      11112111111        1113                   11111            11          1111111121 111111111111     
     2221     111   111111     111211111111   1111          12211111122111111111          1111       1111131111        11111                  11111111         111         111111113111111111   111     
      22      11111111111      112111111111111111           111111112221111311111          111       111  11111       1111111                1111111211  111  1311        111111111111111111    1111    
11            11111111111      112111111111111111           111111112211111111111           11      111    1111      1121111111             11221111111 1111111111       1111111111111111111    1111    
111          11111111111       1111  111311111111111111     1111111111111111 111111             1111111    1111     1111111111311          112221 11111  111111121      111111111111  111111    1111    
1111 11       111111111        111      1111111113111111     11111111111111   111111            1111111     111    11111111111111111111111111221    13    11111222       1111   1111    1311    11111   
1111111        1111113          1         1111221111211      1111111113111    1111111           1111111     1111  11111111211111111111111111111            1111122        11    1111     1111  211111   
1111111        111111                            112211      111111121111     11111111          1111311      111111111111        1111111111         11      11112               1121     1111122111111  
1111111         1111      222                     2221      111              111111111          1111111      111111111111          11111111        1111     11                  1121      111221111111  
1111111          1111    2222     1111111         2211     1111             111211111111        111111       11111                   111111       11111                         1111      111221111111  
1111111          1112   12221    111311111        2111    11111             11111  111111      111111        11111                    11111      12111111   11       111111     111       111111111111  
  11111    1111111111    1111    111111111        11111  11111             11111    11311     1111111        11111                    11111      221111111 11111     111111     11         11111111112  
    1     11211111111    1111   1111111111        111111111111             1111     111111    1113111        111111           1       11112       11111111 11111     111111                      11112  
         111111111111     111  11111111111        11111111111              111      11111    11111111        11111122       111111111111122         11111   11131     1111      111              1311222
          11111111111         111121111221        111111111       21111311111       111      11111111        111112211     1111111111111121  1      1111    111111             11111111111      11122111
 11             11111        1111111  1111         11111         221111111111     1111       11111111         11111111    111111111111122111111      11     111111            11111111111111   111121 11
